+++++++++++++++++++
+0AA              +
+ A               +
+                 +
+       a         +
+      A          +
+++++++++++++++++++
