+++++++++++++++++++
+0                +
+               + +
+              +  +
+              ++A+
+              +a +
+              ++++
+                 +
+                 + 
+++++++++++++++++++
